******
**..,*
*..,.*
*.,.**
**,***
