+---+---+
|   |   |
|W03 W04 
|   |   |
+- -+- -+
|   |   |
|W01 W02 
|   |   |
+- -+- -+
|   |   |
|I-S|   +
|   |   |
+---+- -+
